おはよう|おはよう
ありがとう|ありがとう
おかえり|おかえり
ではまた|ではまた
お疲れ様|おつかれさま
ごめんなさい|ごめんなさい
眠たい|ねむたい
楽しい|たのしい
嬉しい|うれしい
さむい|さむい
元気です|げんきです
ありがとうございます|ありがとうございます
おはようございます|おはようございます
おつかれさまです|おつかれさまです
よろしくおねがいします|よろしくおねがいします
はじめまして|はじめまして
気をつけて|きをつけて
頑張って|がんばって
もうちょっと|もうちょっと
本当にありがとうございました|ほんとうにありがとうございました
お手伝いしましょうか|おてつだいしましょうか
私は行きます|わたしはいきます
ネビュラコーブ|ねびゅらこーぶ
海の深淵|うみのしんえん
無理しないで|むりしないで
海がきれい|うみがきれい
いい天気だ|いいてんきだ
クジラがあくび|くじらがあくび
お父さん|おとうさん
メッセージ|めっせーじ
魚の切り身|さかなのきりみ
寿司は寿司屋|すしはすしや
お腹すいた|おなかすいた
ちょっと待って|ちょっとまって
寝坊した|ねぼうした
夕焼けが見えるよ|ゆうやけがみえるよ
そろそろ帰ろう|そろそろかえろう
渡り鳥|わたりどり
太陽|たいよう
入道雲|にゅうどうぐも
星の鼓動|ほしのこどう
観光地|かんこうち
パーカー|ぱーかー
現像|げんぞう
自然の家|しぜんのいえ
よくやったね|よくやったね
指文字が難しい|ゆびもじがむずかしい
手話の八が難しい|しゅわのはちが難しい
コミュニケーション|こみゅにけーしょん